......@.........
.##.......####-.
..........####..
................
................
................
................
................
................
..1...........X.
.###############
.###############
