.....#.....#....
....@#.....##...
....@.....###.X.
....@.....#####.
....@########...
....#####.###...
....##...D###...
...a#########d..
..#######.######
.1####..#B######
.###############
..#############.
