................
................
.......A........
.....###........
................
..b.........c...
..@@.......@@...
................
.........D......
..1....$@##...X.
.##$.###########
.##$.###########
