................
............1...
.@@..@@@@@@@@@@.
................
................
................
................
................
................
..............X.
.###############
.###############
