................
................
...........P.B..
..X........@@@@.
.##....@@.......
.##G............
.###............
.###G.....G##.1.
.####....G#####.
.####...G######.
.####$$$#######.
..####$$#######.
