................
..G.G.G.G....X..
.G.G.GBG.G#..@@.
.##########.....
................
................
..............@@
................
................
..1.............
.#####......$##$
..#####....$###.
