................
................
................
................
................
.......B......X.
.....######..@@.
....##..........
................
..1.............
.###############
.###############
