................
................
................
.........1......
........##......
......####......
...X..#@##......
...####@##......
...##@@@##......
...##@@@##$$....
.###@@@#########
.###############
