................
.1.G.G.#D.......
....G..####...GX
...@@@.......G@@
............@@..
................
...a....a.....c.
.$##....@$....@$
.$##...##$...##$
.$##...##$...##$
.$##...##$..###$
..##...##$..###.
