................
................
................
................
......G###....1.
......####...$##
...X.G#@##......
...####@##......
.P.##@@@##......
..G##@@@##......
.###@@@#########
.###############
