................
....##.....##...
...G@@@##@@##.X.
..G.@@....@####.
..@@##.....##...
....##.G.G.##AP.
....##G.D.G###..
...c###########.
..###.......###.
.1###..B....###$
.##############$
..#############.
