......@.........
.####.....#.....
................
................
................
................
................
................
................
..1...........X.
.###############
.###############
