................
..,.............
.$###.......###$
.####...........
.####-..........
................
..............X.
........@#######
.$$@@@..........
................
....1.....A.....
.##########..###
