.#..############
.###############
.###############
.###############
................
........GGG.....
........###.....
.....G......G...
....G.G....G.G..
....###....###..
..1.......X.....
.###############
