................
................
................
................
................
.........A....X.
.....######..@@.
....##..........
................
..1.............
.###############
.###############
