................
................
..........B.....
..###....@@@@@..
................
................
..........D.....
..@@@....@@@@@..
................
..1...........X.
.###############
.###############
