................
................
................
................
............@@@.
.......##.......
.....####.......
................
...........@@@..
..1..G..X.......
..#############.
.###############
