....G...........
...G.G..........
.@###@#.$#....1.
...........#.$#.
...........#..#.
..G......G.#..#.
.X#.....G#.@@.#.
.#.....G#.....#.
.#.....#......#.
.#.G...##.....#.
..##G.G.###.a.#.
...####....###..
