...###.....###..
.#####.....###..
.###.......#####
.##....G.G....##
.#....G@$@G....#
......@...@.....
................
.....G......G...
....G.G..P.G.G..
..1.###.B..###X.
.$#############$
..#############.
