................
............1...
............####
................
................
................
................
................
..............G.
...XG........G.P
.$$##$......$###
..$##$......$##.
