................
................
.P.G.G..G.G.G...
..G.G....G.G....
.#####..###@@...
................
................
............@@..
................
...X......B.....
.$###$$.@@@@@@1.
.####$$.########
