................
..1.......G..X..
.........##..##$
........G##..##$
.......@@.......
......G@@.......
.....@@.........
....G@@.........
...@@.....G.G.G.
..a@@...dG.G.G.G
.##....$########
..#...$########.
