................
.#..........1...
.####.....--####
.........--.....
........--......
.......--.......
......--........
.....--.........
................
...##.....##--.X
.#######..######
.###############
