................
..1..a........X.
..#####...G.G.##
..$$$$#.......##
..$$@@@##...@d##
.#$$#@#@@##@@###
.##$@@#@@@##@###
.$#$#$#@@@#####@
.$#$$..$#.......
.$#$$..$#..#....
.$#######..#####
.$$$$$###..#####
