....G...........
.P.G.G.G...X....
.#######...@$...
................
..G.G.G.........
.P.G.G.G.#......
.#######..$..@$.
................
..G.G.G.........
.P.G.G.G...B..1.
.#######.@@@@.#$
..@@@@@#......#.
