................
............a...
...........d#...
..........@@...P
......b..$....##
.....##.........
....$........G..
.............##G
.1..........G###
.@@....X....####
.###...#..$@####
..##...#..$####.
