................
.#........#.....
................
................
................
................
................
................
................
..1...........X.
.###############
.###############
