................
................
................
................
................
................
................
................
................
..1...........X.
.#####$....#####
.######$..######
