.....#.....#....
....@#.....##...
....@.G.G.###...
....@G.G.G#####.
....@########...
....##....###...
....##...D###...
...a#########X.c
..####....######
.1####...B######
.###############
..#############.
