................
.#############..
.##............#
.#.....G...G...#
.#1...@#$..@...#
.#######$....G.#
.#...........@.#
............G..#
............@..#
..X........D..P#
.$##$...$#######
..##$...#######.
