................
.a.a.a..........
.#.#.#.#..#.....
...........@@...
................
................
...A.....P......
..##....####....
................
.1....G.G.....X.
.###############
.###############
