................
.####.....####-.
..........####-.
................
................
................
................
................
................
..1...........X.
.###############
.##..##..##..###
