................
....G##.......1.
.Pb##.......$###
.##.............
.......$........
....G##....a..G.
.G.##......##G.G
.##.........####
................
.............G..
..X.d.$$$$$.G.G.
..####$$$$$####.
