................
.###......###...
................
................
................
................
................
................
................
..1...........X.
.###############
.###############
