................
................
.X...........G.G
.###$.........G.
.............###
.....b..........
...####$........
..........@@@...
................
.....A........1.
.$#######$######
..#######$#####.
