................
.1.G.G.#D.......
....G..####....X
...@@@........@@
............@@..
................
...a....b.....c.
.$##....@$....@$
.$##...##$...##$
.$##...##$...##$
.$##...##$..###$
..##...##$..###.
