................
...XG..aGc.G.G..
..###$$@@@####..
..#...........@@
..#..G.G........
..#BG.G.G.......
..#######..###..
.............#..
.P.G.G.G.G.G.#..
..G.G.G.GDG..#1.
.##############$
..#############.
