................
.....A..........
.#####@@@@@##...
................
.....A..........
.#####@@@@@##...
................
................
..#@####@@@###..
................
...1...........X
.###############
