................
.............X..
.##........#####
.##.D...........
.####-..........
................
..........B.....
........@#######
................
................
....1..........C
.#####..########
