....G...........
.PDG.G..........
.@###@#.$@....1.
...........#.$#$
...........#..#$
...G.....G.#..#$
.X.@@...G#.@..#$
.#.....G#...@.#$
.#P.G.G#......#$
.#...C#.......#$
.##########.a.#$
..#############.
