................
............#...
.P..........#.1.
..A.........$##$
.####..@@@......
.......$$.......
................
................
.....G.G...B..G.
..Xc..G....####$
..######..#####$
..######..#####.
