............#...
..1.........#X..
...#........##@#
...#.........#@@
...#...C.....#@@
....@#@@#$....#@
...........d..@@
...........#..@@
..........$...##
.P..@...A.#...##
.@$.#######..$##
..$.#######..##.
