................
..G.............
.G.G........d.X.
.###........####
.###..@@@$....##
.###............
.###1.....@@....
.####...........
.####...........
.#####.C......P.
.##############.
..#############.
