................
.###############
.###############
.##...........##
.#.............#
.#........G....#
.#...P#..##G...#
.#...##.$$#.G..#
.#...##.$$##.G.#
.#Xa.##.$$###.1#
.###$##.$$######
..##$##.$$#####.
