................
...B..........1.
.####.......####
................
................
.####.......####
................
................
.####.......####
................
.X..............
.###############
