................
.A.B............
.#.#.#.#..#.....
...........@@...
................
...........P....
..c.d....P......
..@@#...####....
......G.........
..1.G...G..X....
.########..#####
.###############
