.....G.....G....
..1.G.......G...
....@@.....@@...
................
.........B..P.d.
.$@.@..####.###$
.$#.#..#@...#@#$
.$#.#..#@...#@#$
.$#.#.P#@...#@#$
.$#.#.@#@X..#@#$
.$###.@#@#$@#@#$
.$###.@#@#$@#@#$
