................
..G.G.G.G.......
.X.G.GBG.G#..@@.
.##########.....
................
................
..............@@
................
................
..1.............
.#####......$##$
..#####....$###.
