................
....##..........
..G.###..@@@@...
.G.G###..@..#...
.@@@@....@c.#...
.@@@@.....@@#1..
.......G....@@$.
.......#G.......
.....G.###.....P
..XDG.G###G..B..
.$##############
..#@@@#####@@@#.
