................
............1..A
.####.......####
................
................
.####.......####
................
................
.####.......####
................
.X..............
.###############
