................
............1...
...........$###@
................
................
................
..............@@
................
..............G.
..X..........P.P
.$#$........$###
..#$........$##.
