.###############
.#........##...#
.#.............#
.#.............#
.#.............#
.#.............#
.#.............#
.#.............#
.#.............#
.#1...........X#
.###############
.###############
