................
................
................
................
................
................
................
................
................
....1.X.........
.###############
.###############
