................
.###......#.....
................
................
................
................
................
................
................
..1...........X.
.###############
.###############
