................
...1............
.#.#.#.#..#.....
...........@@...
................
................
...d.....c......
..@@#...####....
................
......a...b...X.
.###############
.###############
