....G.......G...
...G.G.....G.G..
...@@@.....@@@..
................
.1.......B....dP
.###..$###$..###
.#@#..$#@#$..#@#
.#@#..$#@#$..#@#
.#@#.P$#@#$..#@#
.#@#.@$#@#$X.#@#
.#@#.@$#@#$@@#@#
.#@#.@$#@#$@@#@#
