................
......1...PXG...
..G.......@@@...
.G.G............
.@@@...........G
.@@@.........@@@
.@@.............
............CG..
...........@@@$.
....a...b.......
.$###$$$##......
..###$$$##......
