................
.X.A........#...
.######$$@@@##d.
..............#.
......B.........
....#####.......
................
...1............
...####@@@####..
................
...............b
.###############
