................
............#...
.G.G........#.1.
..GA....c...###$
.####..@@@......
.......$$.......
................
...........G.G..
.....G.G...DG.P.
..Xc..G....####$
.$######..#####$
.#######..#####.
