................
..1..a........X.
..#####...G.G.##
..$$$$#.......##
..$$@@##b..@.##.
.#$$#@#@@.c.@.##
.##$@D#@@@#.@..#
.$#$#$#@@@#####@
.$#$$..$#.......
.$#$$..$#..#....
.$#######..#####
.$$$$$###..#####
