....G.G.G.......
..1G.G.G.G.....X
.$########$....#
..............G#
........G.....@@
.......G.G-----.
.......###$....G
.......#......@@
...G.G.#.G.G....
..G.G.G#P.G.C.G.
.$#############$
..#############.
