................
................
.X..GCG...d..G..
.##.@@@#..#.G#..
............##..
...........G#..@
..#P......G#...@
..##.....G#....@
.P.G.G...#......
..G.G.GA.#...1..
.#######$#####$$
..######$#####$.
