.....G..........
...1G.G.G.......
.$########$...X#
..............##
.#G.....G.....@@
.##....G.G@@@@..
.......###$....G
.......#......@@
...G.G.#.G.G....
..P.G.A#P.G.C.G.
.$#############$
..#############.
