................
...P.........X..
.@@@.....G...@@@
........#....###
........##G..###
.G.G.G..##...###
..G.G...###.G###
.#####..###@@###
.###............
.###.a.b.c.d..1.
.##############$
..############$.
