................
................
.X..GCG...d..G..
.##.@@@#..#.G#..
...........G#...
..........G#...@
..#P.....G#....@
..##....$#.....@
...G.G...#......
..G.G.A..#...1b.
.$#####$.######$
..#####$.######.
