................
.G.............G
.@@...........@@
..........A.....
..G...$####...G.
.@@...........@@
................
.G.............G
.@@...........@@
...1.........X..
.####$$$$$$$####
..###$$$$$$$###.
