................
................
.G...G...G..G...
.@@....D......X.
....###########$
................
..G.............
.@@.............
................
......a...b...1.
.$#..#######..#$
..############..
