................
.............A..
..############..
................
.............C..
..############..
................
................
................
..1...........X.
.###############
.###############
