................
...1........P...
............@@..
.........G..@@..
.........@@.....
.........@@.....
.......G........
.......@@.......
.......@@.......
..G..G......aXd.
.$#$$#.....$###$
..#$$#.....$###.
