................
..............X.
.##........#####
.##.............
.####-..........
................
................
....A...@#######
.$$@@@..........
................
....1..........C
.##########..###
