................
.............B..
..@###########..
................
................
.............D..
..@###########..
................
................
..1.........aX..
.###############
.###############
