................
................
................
................
................
................
................
................
................
..1GX...........
.###############
.###############
