................
............1..A
.####.......####
................
...............B
.####.......####
................
...............C
.####.......####
................
.X.............D
.###############
