................
..P........d.X..
.##......$######
.##G......G.G...
.####-...G.G.G..
...G....G#####G.
..A.G..@@.....@@
$@@@@...........
................
....1........C.P
.########$..####
..#######$..###.
