................
................
................
................
................
...1............
.########....###
................
................
................
..............X.
.###############
