................
.A............1.
.####.......####
................
....A...........
.####.......####
................
................
.####.......####
................
.X..............
.###############
