................
.1.G.G.#D.......
....G..####...GX
...@@@.......G@@
............@@..
................
..Ga....a.....c.
.$##...G@$...G@$
.$##...##$...##$
.$##...##$..G##$
.$##...##$..###$
..##...##$..###.
