................
...1........@@..
............@@..
.........G......
.........@@.....
.........@@.....
.......G........
.......@@.......
.G...G.@@.......
............aXd.
.#$$@#......###$
..$$@#......###.
