................
............#...
.P.G........#.1.
..G.a...G...$##.
.####$.c@@......
.......@@.......
................
.............G..
.....G.G...BG.P.
..XDG.G...G####$
.$######..#####$
..######..#####.
