....G#.....#G...
....@#.....@@...
....@.....#@@G..
....@.....#.###$
....@#$...#.#...
....##....#.$...
....##...D#.....
...a##@@@@#...Xc
..####......####
.1####...B..####
.###############
..#############.
