................
................
.......A........
.....###........
............c...
..b........@@...
.@@@............
................
.........D.G.G.G
..1....$@##.G.X.
.##$.###########
.##$.###########
