................
...G.G.....GBG..
..$###@#######..
................
.....G.G.G.G....
...D..G.G.G.....
..$#######@###..
................
...G.G.G.G.G....
.1..G.G.G.G.aX..
.###############
..#############.
