................
................
................
..............X.
............@@@.
.......##.......
.....####.......
................
...........@@@..
..1.............
.###############
.###############
