................
.AX.............
.#####@@@@@##...
................
.......1........
....#####.......
................
.....A..........
..#@####@@@###..
................
...A............
.###############
