................
....G.G.#..@@#1.
..AG.G.G#G.G.#..
..#@@####.G.G#..
....@@####@@#@..
.....@@##....@..
......@@#..G.@..
........#..@@@..
........#.G.G...
..d.b..X#P.C.G..
.$###$$########$
..###$$########.
