................
..........@@d...
.........$..@...
................
......b.........
.....@@.........
....$........G..
.............##G
.1..........G###
.@@........X####
.###......$@####
..##$.....$####.
