................
.#####....@@#1..
.#...@..G.G.#...
.#B..@.G.G.G#...
.##@@..##@@#@...
.#@@...#....@...
.......#....@...
.......#..@@@...
.......#..G.G.G.
.Xac...#P....D..
.####$$########$
..###$$########.
