................
..............X.
.####.....######
.####.C.........
.######.........
................
..1........B....
..#.....########
..#.............
..#.............
..#A............
.###############
