.........G.G....
...PA...G.G.G...
.####...#####...
................
.....G......G...
....G.G....G.G..
....###....###..
................
................
..1....D......X.
.$#############$
..#############.
