................
................
................
................
................
................
................
................
................
....1...........
.###############
.###############
