................
.X......1a......
.######$$@@@##..
................
................
....#####.......
................
................
.#@####@@@####..
................
................
.###############
