................
..1...........X.
.######...G.G.##
.#$$$$#G...G..##
.#$$@@@@##@@@.##
.#$$@@@@@##@@###
.##$@@@@@@##@###
.$#$$@@@@@@####.
.$#$$$$$#.......
.$#$$$$$#.......
.$#######..#####
.$$$$$###..#####
