................
....##..........
..G.###..@@@@...
.G.G###..@..#...
.@@@@....@c.#...
.@@@@.....@@#1..
.......G....###$
.......#G.......
.....G.###.....P
.X.DG.G###G..B..
.###############
..#@@@#####@@@#.
