................
.#..1#######@@..
.#...........@@P
.#............@@
...............#
.....@@#.......#
.......#..$#...#
.b.....#..$#...#
.#.....#..$#...#
.#G.GAG#..$#Xd.#
.#.@@@@#..$#@@.#
..######..$####.
