................
................
................
................
........##......
......####....1.
...X..#@##...$##
...####@##......
...##@@@##......
...##@@@##$$....
.###@@@#########
.###############
