................
................
................
................
................
................
................
................
................
....1.........X.
.###############
.###############
