.###############
.#........##...#
.#.............#
.#.............#
.#.............#
.#.............#
.#.............#
.#.............#
.#.............#
.#.1..........X#
.###############
.###############
