................
...G............
.@@@G...###.d..X
..@@@G....##@@##
....@@..........
................
..PA.......@@$..
.@####$.........
................
....1..........B
.######....#####
..#####$..$####.
