................
....##.....##...
...G@@@##@@##.X.
..G.@@@@$$@#$@#.
..@@##.....##...
....##.G.G.##...
....##G.d.G##aP.
...c###########.
..###.......###.
.1###..B....###$
.##############$
..#############.
