................
....##.....##...
...G@@@##@@##X..
..G.@@@@$$@###..
..@@##.....##...
....##.G.G.#....
....##G.d.G#a.P.
...c###########.
..###.......###.
.1###..B....###$
.##############$
..#############.
