................
..P........d.X..
.##......$######
.##G......G.G...
.####-...G.G.G..
........G#####G.
..GAG..@@.....@@
$@@@@...........
................
....1........C.P
.########$..####
..#######$..###.
