................
.....1....GXG...
..G#.....$@@@...
.P.#............
.@##..........#.
.@#@.........@..
.#@.............
............C.P.
...........####$
..G.a....b......
.$###$.$##......
..###$.$##......
