................
..1..........P.P
............####
.......C.....###
...@@@@@$$....##
...@@@@@......##
..............##
..............##
........D.....##
.P..@@@####..X##
.@$.#######..@##
..$.#######..@#.
