................
.###......##....
................
................
................
................
................
................
................
..1...........X.
.###############
.###############
