................
..1..a........X.
.######...G.G.##
.#$$$$#G...G..##
.#$$@@@@#..@@d##
.#$$@@#@@b.@@###
.##$@@@@@@##@###
.$#$$@@@@@@####.
.$#$$$$$#.......
.$#$$$$$#...C...
.$#######..#####
.$$$$$###..#####
