................
...XG...G.GdG...
..###$$@@@#@@$.G
..@...........@@
..@..G.G....G...
..@CG.G.G..G.G..
..#######..###..
.............#..
.P.G.G.G...G.#..
..G.G.G.GAG.G#1.
.##############$
..#############.
