............#...
..1.........#X..
...#........##@#
...#.G.......#@@
...#P.GC.....#@@
....@#@@#$....#@
...........d..@@
...........#..@@
..........$...##
.G..@...A.#...##
.@$.#######..$##
..$.#######..##.
