....P...........
..G1............
.######.........
................
...,............
............####
.########.......
................
................
.............X..
.###############
.###############
