................
................
................
................
................
................
................
................
................
..1X............
.###############
.###############
