................
.X.A.......d.#..
.######$$@@@##..
..............#.
......G.G.G.....
...1............
...####@@@####..
................
................
..c............B
.########..##..#
.#########.#####
