................
.##1.#######@@..
.#..........#@@P
.#............@@
.#@............#
......##.......#
.....@.#..$#...#
.b.....#..$#...#
.#.....#..$#...#
.#G.GAG#..$#.dX#
.#.@@@@#..$#@@@#
..######..$####.
