................
.#..............
.####.....--####
.........--.....
........--......
.......--.......
......--........
................
................
....1.....##--.X
.#####....######
.#####....######
