................
............#...
.G.G........#.1.
..G.B...G...$##$
.####..c@@......
.......@@.......
................
.............G..
.....G.G...DG.P.
..XcG.G...G####$
.$######..#####$
..######..#####.
