................
..G......G..XG-.
..#......#..@@@.
..#1.....#......
..##G....##.....
...##.....#G....
...@@..@@.##..@@
....@@....##....
...G##.....##..G
.bG.P#..B..##.G.
.############$##
..###########$#.
