................
................
................
................
......G.G.G.....
.....G.G.G.G....
....#########...
................
......G...G.....
..1.....G.....X.
.###############
.###############
