................
.##1.@#####@@...
.#...$......#@@P
.#............@@
.#.............#
..$...##.......#
.....@.#..$#...#
.b.....#..$#...#
.#.....#..$#...#
.#G.GCP#..$#.AX#
.#.@@@@#..$#@@@#
..######..$####.
