................
.X.A........#...
.######$$@@@##c.
..............#.
.........b......
....#####.......
................
.1..............
.#@####@@@####..
................
...............D
.###############
