................
.....a........X.
..#####...G.G.##
..$$$$#.......##
..$$@@@##1..@d##
.#$$.@#@@..@@###
.##$..@@@@##@###
.$#$#$#@@@.####.
.$#$$..$#.......
.$#$$..$#..#....
.$#######..#####
.$$$$$###..#####
