................
..G.............
.G.G1......d..X.
.###....B..@@###
.###..@@@.....##
.###............
.###......@@....
.####...........
.####....G.G.G..
.#####.C..G.G.P.
.##############$
..#############.
