................
................
................
................
................
................
................
................
................
..1GG..X........
.###############
.###############
