................
....G.G.#..@@#1.
..AG.G.G#G.G.#..
..#@@####.G.G#..
....@@####@@#@..
.....@@##....@..
......@@#..G.@..
........#..@@@..
........#PG.G...
.d..b..X#C.G.G..
.####$$########$
..###$$########.
