............P...
...1........@@..
............@@..
.........G......
.........@@.....
.........@@.....
.......G........
.......@@.......
..G..G.@@.......
............aXd.
.$#$$#.....$###$
..#$$#.....$###.
