................
..1a..........X.
..#####...G.G.##
..$$$$#.......##
..$$@@##b..@.##.
.#$....@@......#
.##BC..@@@#....#
.$#$#$#@@@#####@
.$#$$..$#.......
.$#$$..$#..#....
.$#######..#####
.$$$$$###..#####
