................
................
................
................
................
................
................
................
................
..1...........X.
.######....#####
.#######..######
