......@.........
.##.......####..
................
................
................
................
................
................
................
..1...........X.
.###############
.###############
