................
....A...........
.###############
....GGGGGGG.....
................
.#####@@@@@##...
....GGGGGGGGGGG.
................
..#@####@@@###..
....GGGGGGGGGGG.
...1...........X
.###############
