......@.........
.#........###...
................
................
................
................
................
................
................
..1...........X.
.###############
.###############
