......@.........
.#........####-.
..........####..
................
................
................
................
................
................
..1...........X.
.###############
.###############
