......@.........
.##.......###...
................
................
................
................
................
................
................
..1...........X.
.###############
.###############
