................
................
......@.........
.#........####..
................
................
................
................
................
..1.X...........
.###############
.###############
