................
................
........@@@@....
......@@@@@@@@@.
.....@@@@@@@@@@.
....@##########.
................
....@@@@@@..#...
.#1...#.....#.X.
.###############
.###############
