................
................
................
................
................
................
.......###......
.......#........
.......#........
.1.....#.......X
.###############
.###############
