................
..1............X
..#####....#####
................
................
..............##
.......###......
.......#........
.......#........
.......#........
.###############
.###############
