................
.....#####......
................
.--.............
..--............
...--...........
.......###......
.......#........
.......#........
.1.....#.......X
.###############
.###############
