................
..1............X
.###############
................
................
................
.......###......
.......#........
.......#........
.......#........
.###############
.###############
