................
................
.###......--####
.........--.....
........--......
.......--.......
......--........
.....--.........
................
...##.1...##--.X
.#######..######
.###############
