...............
..............X
#######..######
...............
...............
...............
...............
...............
...............
.....1.........
###############
###############
