...............
....#####......
...............
...............
...............
...............
......###......
......#........
......#........
1.....#......X.
###############
###############
