................
..1............X
..##############
................
................
..............##
.......###......
.......#........
.......#........
.......#........
.###############
.###############
