...............
...............
...............
...............
...............
...............
......###......
...............
...............
...............
.1...........X.
###############
