................
..1............X
.############..#
...............#
..............--
..........-----.
.......####.....
.......#........
.......#........
.......#........
.###############
.###############
