...............
.1............X
############..#
..............#
.............--
.........-----.
......####.....
......#........
......#........
......#........
###############
###############
