...............
..............X
#######..######
...............
...............
...............
....###........
...............
...............
..##.1...##--..
###############
###############
