...............
...............
..####...####..
...............
...............
.####.....####.
...............
...............
####.......####
...............
.......1.....X.
######   ######

