...............
.1.............
#######..######
...............
...............
...............
....###........
...............
...............
..##.....##--.X
###############
###############
