...............
.1............X
###############
...............
...............
...............
......###......
......#........
......#........
......#........
###############
###############
