...............
.1............X
###############
...............
...............
...............
...............
...............
...............
...............
###############
###############
