...............
...............
###......--####
........--.....
.......--......
......--.......
.....--........
....--.........
...............
..##..1..##--.X
#######..######
###############
