................
................
................
.........1......
........##......
......####......
...X..#@#.......
...####@##......
...##@@@##......
...##@@@##......
.###@@@#########
.###############
