................
................
...####...####..
................
................
..####.....####.
................
................
.####.......####
................
..1...........X.
.###############
