................
.##.......####-.
..........####-.
................
................
................
................
................
................
..1...........X.
.###############
.###############
