................
.......G.G......
...G..$###.....X
..@@.........G@@
............G@@.
.....G.....G@@..
..G..##cG..##...
..@@..###.......
.............@@.
....1...........
.#######$$$####$
..######$$#####.
