................
................
........D.......
.#########......
................
........B.......
.#########......
................
................
..1...........X.
.###############
.###############
