......@.........
.####.....##....
................
................
................
................
................
................
................
..1...........X.
.###############
.###############
