......@.........
.####.....####-.
..........####..
................
................
................
................
................
................
..1...........X.
.###############
.###############
