................
.X.............D
.#........######
.#C.............
.######.........
................
...............B
........########
................
..#.............
.1#............A
.###############
