................
.#........####-.
..........#.....
................
................
................
................
................
................
..1...........X.
.###############
.###############
