................
.##.......##....
................
................
................
................
................
................
................
..1...........X.
.###############
.###############
