................
.............X..
.............@@@
................
.1.......B....d.
.###..$###$..###
.#@#..$#@#$..#@#
.#@#..$#@#$..#@#
.#@#..$#@#$..#@#
.#@#..$#@#$..#@#
.#@#..$#@#$..#@#
.#@#..$#@#$..#@#
