................
.###......####-.
..........####-.
................
................
................
................
................
................
..1...........X.
.###############
.###############
