................
....##.....##...
...G@@@##@@##.X.
..G.@@....@####.
..@@##.....##...
....##.G.G.##A..
....##G.D.G###P.
...c###########.
..###.......###.
.1###..B....###$
.##############$
..#############.
