................
...G.G.....GBG..
..$###@#######..
................
.....G.G.G.G....
...DG.G.G.G.G...
..$#######@###..
................
...G.G.G.G.G....
.1G.G.G.G.G.GaX.
.##############$
..#############.
