................
................
................
................
................
........A.....X.
.....######..@@.
....##..........
.......G.G.G.G..
..1.....G.G.G...
.###############
.###############
