................
............#...
.G.G........#.1.
..GB........$##$
.###$..c@@......
.......@@.......
................
...........G.G..
.....G.G...DG.P.
..Xc..G....####$
.$######..#####$
.#######..#####.
