................
....1.#.......X.
..#####...G.G.##
..$$$$#.c.....##
..$$@@####@@@##.
.#$............#
.##.B..........#
.$#$#$#@@@##..#@
.$#$$..$#.......
.$#$$..$#.....d.
.$#######..#####
.$.........#####
