................
................
.......A........
.....###........
............c...
..b........@@...
..@@............
................
.........D......
..1....$@##...X.
.##$.###########
.##$.###########
