................
................
................
................
................
.........A....X.
.....######..@@.
....##..........
................
..1..a..........
.###############
.###############
