......@.........
.###......####..
................
................
................
................
................
................
................
..1...........X.
.###############
.###############
