................
............#...
.G.G........#.1.
..GB........$##$
.###$..c@@......
.......@@.......
................
...........G.G.P
.....G.G...DG...
..Xc..G....####$
.$######..#####$
.#######..#####.