................
................
......X.....B...
.....##@...@@@@.
................
.##.............
.###............
.###.......##.1.
.####.....#####.
.####....######.
.####$$$#######.
..####$$#######.
